NO bonus/texture/NO.png
SO bonus/texture/SO.png
EA bonus/texture/EA.png
WE bonus/texture/WE.png
C 100,9,100
F 245,207,162


1111111111111111111111111111111111111111111111111111111111111111111
100000000000000000D000000000000000000000000000000100000000000000001
1111111111111111111000000000000000000000000000000100000000000000001
1000000000000000000000000000000000000000000000000100000000000000001
10000000000000000000000000000N0000000000000000000100000000000000001
1000000000000000000000000000000000000000000000000100000000000000001
1111111111111111111111111111111111111111111111111111111111111111111     