NO ./texture/NO.png
SO ./texture/SO.png
EA ./texture/EA.png
WE ./texture/WE.png
C 100,9,100
F 245,207,162

11111
10101
11N11
11111
11111
11111
