NO ./texture/NO.png
SO ./texture/SO.png
EA ./texture/EA.png
WE ./texture/WE.png
C 100,100,100
F 245,207,162

111111111111111111                         11111111111111111111111111111111111111
100000000000000001                         10000000000000000000000000000000000001
100000000000000001                         10000000000000000000000000000000000001
100000000000000001111111111111111111111111110000000000000000000000000000000000001
10000000W00000000D0000000000000000000000000D0000000000000000000000000000000000001              
100000000000000011111111111111111111111111110000000000000000000000000000000000001
100000000000000001                         10000000000000000000000000000000000001 
111111111111111111                         11111111111111111111111111111111111111