NO ./texture/NO.png
SO ./texture/SO.png
EA ./texture/EA.png
WE ./texture/WE.png

C 100,100,100
F 245,207,162

11111111111111111111111111111111111111111111111111
10000000000001000100000000000000001000001010010001
10011000110101010010100011011000001000110001000111
10000101000101001000100100100101000001000100010001
10010010010010001111001000100000111010001001101001
10100100100100010000100110001010000100001010000101
10100100010010100010101001000001010000010000100101
10100001001100101100100000010010011000100101000101
10111001110000100010010110100100100000011000111001
10000100000100111001001000101001000110100010000101
10110010001111000100101000101010011000100000010101
10001001100100001010100110100000100011000101000101
10011100010101010000101001011010000100000000100101
10101001000010010110000000000100001010011001001001
10100001001000010001110101100101101000100001010001
10010101000110011000001010001000001001010101000011
10010100001000100111101000010001001010010100010001
10100010101001010000001000011000000010100110100101
10001010110010000001000110000101111000101001000101
11101000001010011010010000110010000010001000001001
10000100100010100100101001001010010010110010010001
10010101011100000101000100100010000101000011100101
10010100000000100100010010101100001000001100000011
10100100010001001010001010100001001010100000111001
10000100101001100011101010011100101100010111000111
10010000001000010100010010100001000001010000010001
10001000010011011001001010011000100010010001101101
10001001100100000001001001000010111010000010000001
10010010001000111010010100100100000000111010100001
10100010100110000100010000010101100101000010011101
10000100010001100010000100010010010100010100000001
11110001001000001000000011001010100010100001011001
10001101101010001100110100110010000100100000100001
10100000001001010011001000000100100101000001001101
10010011100100000000001010111000010000101010010001
11100100010010111111001001000110010100101010111001
10001001010010000000100101010000010010100010010001
10110010010001001100010100011001001010100100001101
1000001000010011001D100100000100101000100111000001
10001000101001000010101010100110000101010000101011
10010101010010001010100000010001010100000110101001
10010100000100100010111111100001010100101000100101
100100100000010000100D0000000110010110101000110001
10001000001100100001110010001000100000101000001011
1D101001010010010010000001010011011001000110001001
10100100010011001001001100100100000100010000100001
10110100000100100101010010010010010000000000000001
10000111111000001001100011010010100000100000110001
1000000000000100D000000000010010010010000000000101
11111111111111111111111111111111111111111111111111
1000000000000100D000000000010010011111111111111N0001
11111111111111111111111111111111111111111111111111