NO ./mandatory/texture/NO.png
SO ./mandatory/texture/SO.png
EA ./mandatory/texture/EA.png
WE ./mandatory/texture/WE.png
C 1,1,1
F 1,1,1

11111111111111111111111111111111111111111111111111
10010010100010000100001000000100100010001000100101
10001000001000000011000010010100001000001000010001
10101000110000110000110000100101001110100011010001
10001001001001001100000100000110000000100000011001
11000100000101010001111010000000011101010111000011
10011000110101000010000000111110100010001000100001
10100001001001000100100101000000101000101010011111
10100100010001111001000100010100100100100011000001
10001010100010000010011011001000010001010000000101
10000010100010011000000000010001010010010011101001
11110100010100100101011100100010100100011000010001
10001000010001000100100010000100000101000101001001
10100000001000000010101001111000010010010100101011
10010111001010000100100100000100101000100101001001
11010000100100111000100100010001000001001001000101
10010010010011000101000011100010010100000100110001
10001010010100010100001000000000100101110101001001
10010010010100100011000101010010000110001001001001
10100001100001010100110001001001101000100010000101
10101010001010010000001010000010010010011101011001
10101100100100001100001000100100000010000000000101
10100010010001010001110010000001110000001111010001
10001000101100100010000101011010001110010000001111
11100100100010000101000100000100100001010100100001
10000011010001100100010010100001000100100010010101
10000100000100001001010000011010010010010100011001
11000100010011110001001101000100001001010010000101
10000100001000000110100000110010100101001001100011
101001100011001S0000010011001100110000100100011001
10001000100011000101001100000001001011000000000101
10100100001000010100010001110000000000111101011001
10010111001001000110010110000011110000000000100101
11010000000010110000010000100100001110110011000001
10010010010100001011111101000000010001001000001001
10001100010011001000010000111000100101010110000001
10010010001000010001001010000111001001000001010001
10000000100110100100100001110000001001101001000111
10011101000001000010010010001100010000000101001001
10100001001000001001100010100001001010010001010101
10001001000110110000001010010010101001001001010001
10010110101001001011110011000010001000101010010101
10100000010000100100001000101001000110101010100101
10010001000010100000110010101001000000101000100101
10011101001000001011000100101010001100101010000101
10100000100111010000010001001000010001001011000101
10100010110000001011001100001001100010001000100101
10110001001110100100110010100010000010010100111001
10000100000000100000000000100000100000100000000001
11111111111111111111111111111111111111111111111111
