NO ./mandatory/texture/NO.png
SO ./mandatory/texture/SO.png
EA ./mandatory/texture/EA.png
WE ./mandatory/texture/WE.png
C 0,0,0
F 0,0,0

11111111111111111111111111111111111111111111111111
10010100000001000010000000000000000000010000100111
10000000100100011011000001001001111001010010000011
10100001000010100000101010111110000010000011001001
10110110011001000110001000001000110100111100010011
10001001000101010001100110001011000000000001000001
11101001010101001100010001010000110001110010101001
10001001100101100010010101010010001110000100010011
10010000000010001010010100010011100000101001010001
10100100000010110010011000001100010011000010001011
10010010001100000100000001010001000100000100101001
11001001010001011011010010000110100000110001001101
10010100100100100000101010111000001110001100100001
10000010000100001110001001000110010001000010011001
10000101001010010000100101010000100100010010100001
10001000001001001000010100010000001011000100101101
10001010000000100010010101100011100000101000100011
10000011100110000101010010010100010010001001011001
11100100010001001000001001010100001001001001000101
10001001001001001010100100010001101001010000100101
10010010100101001010010100101110001000100110000101
10001010000101001001000010000001000110111001000101
11001010001000110010100101110000101000000000001001
10100011100010000100101000001010101000110000010001
10110000010000100100100011001010101101001000100001
10000101010100110000101000001011000010000100001101
10001000100100001010010101110000011010010010110001
10010010001011001001000100000110000000100010001001
10101001001000010100110110110001100111001101000101
10100010110001000001000001000010010000100000010101
10010100000101110010001010010100000011011111000101
11010001100100000100001001001001100100000000100101
10000010000010101001100110001010001001110101000101
10001010010001001010000000101001000100001001001001
100101001011001100101110000001011110101010001W0001
10010001000000000001000111000100000010010011011011
11010100111100111001010000111001110010100100000001
10010110000001000110010010000010001000010000110101
10010000010010010000001100110000101100011001000001
10101011001000000100010001001100100000000110001001
10100100001001110100100101000000101000101000100111
10010001110010001000010100011110101000100011010001
11001000000100100011100010000000101111111000000101
10101001111001011000011001001001000000100100100101
10101010000101000111000101001001000100001001001001
10101010010101001000110100101001110010110001000001
10001000100001010010000010100100001001000110110101
10010101001110000000101000100110000110010000001001
10000001000000010000100000000000100000100100100001
11111111111111111111111111111111111111111111111111

