NO ./mandatory/texture/NO.png
SO ./mandatory/texture/SO.png
EA ./mandatory/texture/EA.png
WE ./mandatory/texture/WE.png
C 100,9,100
F 245,207,162


11111111111111111111111111111111111111111111111111
100000000000000000D0000000000000000000000000000001
11111111111111111110000000000000000000000000000001
10000000000000000000000000000000000000000000000001
10000000000000000000000000000N00000000000000000001
10000000000000000000000000000000000000000000000001
11111111111111111111111111111111111111111111111111
