NO ./mandatory/texture/NO.png
SO ./mandatory/texture/SO.png
EA ./mandatory/texture/EA.png
WE ./mandatory/texture/WE.png
C 7,7,7
F 6,6,6

11111111111111111111111111111111111111111111111111
10000000100000000000000001000000000000010000000001
11110010010011011111011100110100101011010001001001
10001001000100000000100010000100010000111000000101
10100101001010111100101001100101000010010100101001
10100010000000000010100010000001100100000001010001
10011001000110001000100010111010010010110010010111
11000100111001000101000100000000011001001100010001
10110110000000111000010001010110000100000000101001
10000001111110000011010100100001010010011001000101
10100100000001000000010010001100101010100010010001
11001011100100111111001000100000100010101001011111
10001000001010000000100100111011010010000100000001
10100000001001100010010000000100000010010110100101
10111111001100000001001011010100100101000000011001
10000000100000000010001000100100011000101011100001
10010010011101100100101001000100100000101000000101
10010010100010000100101010010000001100100101111001
10111010001001011000001010100110010000010100000001
10010100010100100001000000001001010010000111010101
10010010000010001110001101001001000001100000100101
10011010111000110000010010100001000100011011001001
10000010000101000111000010111000101011000100101001
10111001000100111000101100000100101000000100001011
11000100010010000010100001001001001001010000100001
10010010100010000010000001010010011100100101010101
10100000100001000100001010010100001010101001000001
10011111000100011010010101000100101000010010001011
10000000110010100011000000101001000101000101000101
10100110001001001000010010100010010101111000000101
10100000100101001110010010001010000100000001000001
10101010010001000001100001010010110111111110011001
10000100011000111010001001010100001000000001100101
10001000100011000010000101010011001010001000010001
10010010001100010010000101011000101001000110010011
11000001000001001100110001000100100000110001010001
10010100001001000000001011110001000001001001001001
10100001010110011000010001001001010010000100101011
11001110010000100001100100001001000100110011001001
100100001010100001100001010E1001010100001000010001
10100101000001100000100110000010100000100111000101
10010010001100011000001000111000000010110000100011
10011010010001000110000101000101001100000110001001
11000010010010110001100001010001010010001001010001
10010000010100001000011110001100100001010000010011
10001100100100100001000000010001000100010100000101
10010010000101010100110010010001010010010100100101
10100011111001010011001101100010010000100101011001
10000000000010000000000000001000100100001000000001
11111111111111111111111111111111111111111111111111
