NO mandatory/texture/N.png
SO mandatory/texture/SO.png
EA mandatory/texture/EA.png
WE mandatory/texture/WE.png

C 100,9,100
F 245,207,162


111111111          
1N0000001           
100000001
100000001
111111111